




#  @ ++  {%}             ++              ++            ++     T            ++    P                 ++   $###
#####++##################++##############++############++##################++######################++#######
#####++##################++##############++############++##++    ++        ++        ++       $    ++  ++###
#####++           $   T  ++      ++      ++         $  ++##++####++########++########++################++###
#####++##################++######++####################++##++  $#++########++########++       $    ++  ++###
#++##++            ++####  ######++            $ ######++########++########++######################++#######
#++##++############++####  ############################++     $  ++########++            ++########++#######
#++$ ++############++####  ############################++##################++############++  ++    ++  ++###
#++##++############++####                T   ++   P    ++        $         ++################++########++###
#++##++       P    ++  $   ##################++##############  ############++      T   $ ++  ++########++###
#++$ ++##################  ######      ######++            ++  ############++############++############++###
#####++             T       $####  $$        ++############++              ++    $       ++      $     ++###
#####++######################################++############++###############################################
##   ++                                      ++            ++     $#########################################
############################################################################################################